8 10 4 112
##.##.####
#####..##.
#T#.######
#####.##.#
#########.
.#.#####.#
#########.
S###.#.###